1111111111111
1P1100000C001
1000001000011
1E0001C000001
1111111111111