1111111111111111111111111
1P000000C000000C000000001
101C1101011C010011100C101
1011C01010111011C01111001
1E0000000C00C000000000001
1111111111111111111111111
